####.####################
.####....................
...##....................
####.....................
.####....................
...##....................
####.....................
.####....................
...##....................
####.....................
.####....................
...##....................
####.....................
.####....................
...##....................