###########
#s#...#...#
#.#.#.#.#.#
#.#.#.#.#.#
#.#.#.#.#.#
#.#.#.#.#.#
#.#.#.#.#.#
#.#.#.#.#.#
#...#...#f#
###########