###########
#s#...#...#
#.#.#.#.#.#
#.#.#.#.#.#
#.#.#.#.#.#
#.#.#.#.#.#
#.#.#.#.#.#
#.#.#.#.#.#
#...#...#.#
#########f# 