################
#......#...#...#
#..#.#.#.#.#.#.#
#..#.#...#...#.#
####.#########.#
#....#.......#.#
#....#....#..#.#
#........##..#.f
#.######..#..#.f
#.#....#..#..#.#
#s#.......#..###
###..#.........#
#....#..#####..#
######.........#
#..............#
################