####################
#.....#.........#..#
#.###.#.#######.#..f
#...#.........#.####
#.#.#####.#.#.#....f
#.#...#.#.#.#.######
#.#.......#.#.#....f
###########.########
#s.................#
####################