###############
#.............#
#.#..########.#
#.##..#...#.#.#
#..##...#...#.#
#...##.######.#
#.###.......#.#
#.#.#######.#.#
#.#..#...#..#.#
#s#....#...##.#
###f###########